[
    {
        "Num":1,
        "Endx":9,
        "Endy":2,
        "Maze":[
                    [0,0,0,0,0,0,1,0,0,0],
                    [0,0,0,1,0,0,0,0,0,0],
                    [0,1,1,1,1,1,1,1,1,0],
                    [0,1,0,0,0,0,0,1,0,0],
                    [0,1,0,1,1,1,0,1,0,1],
                    [0,0,0,0,0,1,0,1,0,1],
                    [0,1,0,0,0,1,0,1,0,1],
                    [0,1,0,0,0,1,0,0,0,0],
                    [0,1,1,1,1,1,1,0,1,0],
                    [0,1,0,0,0,0,0,0,1,0]
        ],
        "Enemy":[
            {
                "x":7,
                "y":4
            }
        ],
        "Mine":[
            {
                "x":9,
                "y":9
            }
        ]
    },
    {
        "Num":2,
        "Endx":1,
        "Endy":19,
        "Maze":[
                    [0,0,0,0,0,0,0,0,0,0,0,0,0,0,1,0,0,0,0,1],
                    [0,1,1,1,1,1,0,1,1,0,0,1,0,1,1,1,0,1,0,0],
                    [0,0,1,0,0,0,0,0,1,0,0,1,0,0,1,0,0,1,1,1],
                    [0,1,1,1,1,1,0,1,1,1,1,1,1,0,1,0,1,1,1,0],
                    [0,0,0,0,1,1,0,0,0,1,0,0,0,0,1,0,0,0,0,0],
                    [0,0,1,0,0,1,1,1,1,1,0,1,1,1,1,0,1,1,1,0],
                    [1,0,1,0,0,1,0,0,0,1,0,1,0,0,0,0,1,0,1,0],
                    [0,0,1,0,0,1,0,1,1,1,0,1,0,1,1,1,1,0,1,0],
                    [1,1,1,0,1,1,0,0,0,0,0,1,0,1,1,0,1,0,1,0],
                    [0,0,0,0,0,1,1,0,1,1,1,1,0,1,0,0,1,0,1,0],
                    [0,0,0,1,0,1,0,0,1,0,0,0,0,1,0,0,1,0,1,0],
                    [1,1,0,1,0,1,0,1,1,0,0,0,0,1,1,0,1,0,1,0],
                    [0,0,0,1,0,1,0,0,1,1,1,1,1,1,0,0,1,0,1,0],
                    [0,1,1,1,1,1,0,0,1,0,0,0,0,1,0,0,1,0,0,0],
                    [0,1,0,0,0,1,0,1,1,1,0,1,0,1,0,1,1,1,0,0],
                    [0,0,0,1,1,1,0,0,1,1,0,1,0,1,0,0,0,0,0,0],
                    [0,1,0,1,0,0,0,0,0,0,0,1,0,1,0,1,0,1,1,0],
                    [0,1,0,1,0,1,1,1,1,1,1,1,0,1,0,1,0,0,1,0],
                    [0,1,0,1,0,1,0,0,0,0,0,1,0,1,0,1,0,0,1,1],
                    [0,1,0,0,0,1,1,1,1,1,0,0,0,0,0,1,0,0,0,0]
        ],
        "Enemy":[
            {
                "x":11,
                "y":9
            },
            {
                "x":0,
                "y":15
            }
        ],
        "Mine":[
            {
                "x":10,
                "y":15
            },
            {
                "x":15,
                "y":4
            },
            {
                "x":7,
                "y":19
            }
        ]
    }
]